7 7 7 7 7 7 7 7 7 7 7 7 7 7 7 7 7 7 7 7 7 7 7 7 7 7 7 7 7 7 7 7 7 7 7 7 7 8 7 8 7 7 7 7 7 7 7 7 8 8 8 7 7 7 7 7 7 7 7 7 7 7 7 7 7 7 7 7 7 7 7 7 7 7 7 7 7 7 7 7 7 7 7 7 7 7 7 7 7 7 7 7 7 7 7 7 7 7 7 7 
7 7 7 7 7 7 7 7 7 7 7 7 7 7 7 7 7 7 7 7 7 7 7 7 7 7 7 7 7 7 7 7 7 7 8 8 7 7 7 7 7 7 7 7 7 7 7 8 8 7 7 7 7 7 7 7 8 8 7 7 7 7 7 7 7 7 7 7 7 7 7 7 7 7 7 7 7 7 7 7 7 7 7 7 7 7 7 7 7 7 7 7 7 7 7 7 7 7 7 7 
7 7 7 7 7 7 7 7 7 7 7 7 7 7 7 7 7 7 7 7 7 7 7 8 7 8 7 7 7 7 7 7 7 7 7 8 8 7 7 7 7 8 7 7 7 7 7 8 8 7 7 7 7 7 7 7 7 7 7 7 7 7 7 7 7 7 7 7 7 7 7 7 7 7 7 7 7 7 7 7 7 7 7 7 7 7 7 7 7 7 7 7 7 7 7 7 7 7 7 7 
7 7 7 7 7 7 7 7 7 8 8 7 7 7 7 7 7 7 7 7 7 8 8 8 8 8 8 8 7 8 8 7 7 7 7 8 8 8 7 7 7 7 7 8 7 7 7 7 7 8 7 7 7 7 7 7 7 7 7 7 7 7 7 7 7 7 7 7 7 7 7 7 7 7 7 7 7 7 7 7 7 7 7 7 7 7 7 7 7 7 7 7 7 7 7 7 7 7 7 7 
7 7 7 7 7 7 7 7 7 7 7 7 7 8 8 7 8 8 7 8 7 7 7 8 7 8 7 7 7 7 7 7 8 7 7 7 7 7 7 8 8 7 7 7 7 7 7 8 7 8 8 7 7 7 7 7 7 7 7 8 7 7 7 7 7 7 7 7 7 7 7 7 8 7 7 7 7 7 7 7 7 7 7 7 7 7 7 7 7 7 7 7 7 7 7 7 7 7 7 7 
7 7 7 7 7 7 7 7 7 7 7 7 7 7 7 7 7 7 7 7 7 8 7 8 7 8 8 8 8 7 7 7 7 7 7 7 7 7 7 7 7 7 7 7 7 7 7 8 7 7 7 8 8 8 7 7 7 7 7 8 7 7 7 7 7 7 7 7 7 7 7 7 7 7 7 7 7 8 8 7 7 8 7 7 7 7 7 7 7 7 7 7 7 7 7 7 7 7 7 7 
7 7 7 7 7 7 7 7 7 7 7 7 7 7 7 7 7 7 7 8 7 7 7 7 7 8 7 7 7 7 7 7 7 7 7 7 7 7 7 7 7 7 7 7 7 7 7 8 7 7 7 7 8 8 7 7 7 7 7 7 7 7 7 7 7 7 7 7 8 7 7 7 7 7 7 7 7 7 7 7 7 8 7 7 7 7 7 7 7 7 7 7 7 7 7 7 7 7 7 7 
7 7 7 7 7 7 7 7 7 7 7 7 7 7 7 7 7 7 7 8 7 7 7 7 7 7 7 7 7 7 7 7 7 7 7 7 7 7 7 7 7 7 7 7 7 7 8 8 7 8 7 7 8 7 7 7 7 7 7 7 7 7 8 7 7 7 7 8 8 7 7 7 7 7 7 7 7 7 7 7 7 7 7 7 7 7 7 7 7 7 7 7 7 7 7 7 7 7 7 7 
7 7 7 7 7 7 7 7 7 7 7 7 7 7 7 7 7 7 8 8 8 7 7 7 7 7 7 7 7 7 7 7 7 7 7 7 3 3 3 3 7 7 7 7 7 7 7 8 7 8 8 8 7 7 7 7 7 7 7 7 7 7 7 7 7 7 7 7 7 3 3 3 3 3 3 7 7 7 7 7 8 8 7 7 7 7 7 7 7 7 7 7 7 7 7 7 7 7 7 7 
7 7 7 7 7 7 7 7 7 7 7 7 7 8 8 8 8 8 8 7 7 7 7 7 7 7 7 7 7 7 7 3 3 3 3 3 3 3 3 3 3 7 7 7 7 7 7 7 7 7 7 8 8 7 7 7 7 7 7 7 7 7 7 7 7 7 8 7 7 3 4 4 3 3 3 3 7 7 7 7 8 8 8 8 7 8 8 8 7 7 7 7 7 7 7 7 7 7 7 7 
7 7 7 7 7 7 7 7 7 7 7 7 7 7 7 7 7 7 7 7 7 7 7 7 7 7 7 3 3 3 3 3 3 4 4 4 3 6 6 6 6 6 3 4 3 7 7 7 7 7 7 7 8 7 7 7 7 8 7 7 7 7 7 7 7 3 3 8 3 3 4 5 5 5 4 4 4 7 7 7 7 7 7 7 7 7 7 7 7 7 7 7 7 7 7 7 7 7 7 7 
7 7 7 7 7 7 7 7 7 7 7 7 7 7 7 7 7 7 7 7 7 7 7 7 7 3 3 3 3 3 5 5 6 6 6 6 6 6 6 6 6 6 6 6 4 3 3 3 7 7 7 7 7 7 7 8 7 7 7 8 8 7 7 7 3 3 3 3 4 5 4 3 3 4 4 4 4 3 4 4 3 7 5 7 7 7 7 7 7 7 7 7 7 7 7 7 7 7 7 7 
7 7 8 8 8 7 7 7 7 7 7 7 7 7 7 7 7 7 7 7 3 3 3 3 3 3 5 5 5 6 6 6 6 6 6 2 2 2 2 2 6 6 6 6 6 3 4 4 3 3 3 7 7 7 7 7 7 7 7 7 7 7 7 3 3 4 4 3 5 5 5 4 4 3 3 3 5 3 3 4 5 5 3 3 7 7 8 8 7 7 7 7 7 8 7 7 7 7 7 7 
7 7 7 7 7 7 7 7 7 7 7 7 8 7 7 7 7 7 3 3 3 3 6 6 6 6 6 6 6 6 6 6 6 6 2 2 6 3 3 2 6 6 6 6 6 6 6 4 3 3 5 3 7 7 7 7 8 8 7 7 7 7 3 5 5 4 4 5 5 5 4 4 3 5 3 5 5 5 3 4 5 3 5 4 7 7 7 7 8 7 7 7 8 7 7 7 7 7 7 7 
7 7 7 7 7 7 7 7 7 7 7 7 7 7 7 7 3 3 3 3 5 6 6 6 2 2 2 2 2 6 6 2 2 2 2 2 2 2 6 2 6 6 6 6 6 6 6 6 6 3 3 3 3 3 4 4 7 8 8 7 5 5 5 4 5 4 5 5 5 3 3 4 3 5 5 5 5 5 5 5 4 4 3 5 3 7 7 7 7 8 7 7 8 8 7 7 7 7 7 8 
7 7 7 7 7 8 7 7 7 7 7 8 7 7 3 3 3 3 3 3 5 6 6 6 2 2 3 3 2 6 6 2 2 2 6 2 3 3 2 2 6 6 2 6 6 2 6 6 6 6 6 6 4 4 4 3 8 8 7 5 3 5 4 4 5 4 5 5 3 3 1 1 1 1 1 1 4 5 5 5 4 4 4 3 3 3 3 7 7 8 7 7 7 7 8 7 7 7 8 7 
7 7 7 7 7 7 7 7 7 7 7 7 7 3 3 3 4 4 3 4 4 5 6 6 2 2 2 3 2 6 6 2 2 2 2 2 2 2 2 2 6 6 2 2 2 2 6 6 6 6 6 6 6 4 3 5 3 3 3 5 5 5 5 4 5 4 5 3 3 3 1 1 1 1 1 1 1 1 3 3 4 4 5 5 4 3 3 7 7 7 8 7 7 7 7 7 7 7 8 7 
8 8 7 7 7 8 7 7 7 7 7 7 7 3 3 5 5 5 4 4 3 6 6 6 2 2 2 2 2 6 6 2 2 2 6 6 2 2 6 2 6 6 2 3 3 3 6 6 2 6 6 6 6 4 5 5 4 4 4 5 5 5 4 4 5 4 3 3 3 1 1 1 1 1 1 0 0 0 1 3 3 4 5 4 4 3 3 7 7 7 7 7 7 7 8 7 7 7 7 7 
7 8 7 7 7 8 7 7 8 7 7 7 3 3 3 3 4 4 4 4 6 6 6 6 6 2 2 6 2 6 6 2 2 2 2 2 2 2 2 6 6 6 2 3 2 2 2 2 2 6 6 6 6 6 6 5 5 4 5 5 5 5 4 4 4 3 3 3 1 1 1 1 1 0 0 1 1 1 1 3 3 3 5 3 4 4 3 4 7 7 8 8 7 7 8 7 7 7 7 7 
7 7 7 7 7 8 7 7 7 7 7 7 3 3 3 4 5 3 4 4 6 6 6 6 6 6 2 6 3 6 6 6 2 2 2 3 3 3 2 6 6 6 2 2 3 3 3 2 6 6 6 2 2 2 6 6 3 4 5 4 5 4 3 4 4 3 3 3 1 1 1 1 1 1 1 1 1 0 1 1 1 1 3 3 5 5 4 5 5 3 7 8 7 7 8 7 7 7 7 7 
7 7 7 7 7 8 7 8 7 7 7 3 3 3 4 5 5 5 6 3 6 6 6 2 2 6 6 6 3 2 6 2 2 2 2 2 2 2 2 6 6 2 6 2 2 3 3 6 6 6 2 2 2 2 6 6 6 3 5 4 4 4 3 3 3 3 3 3 1 1 1 1 1 0 1 1 1 0 1 1 1 1 1 3 5 5 5 4 5 3 7 7 7 7 8 7 7 7 7 8 
7 7 7 7 7 7 8 7 7 7 3 3 5 5 5 3 5 6 6 6 6 6 6 2 2 2 2 2 3 2 2 2 2 2 2 6 2 2 6 6 2 2 3 3 2 2 2 6 6 6 3 3 3 3 2 2 6 6 5 5 3 4 3 3 3 1 1 1 1 1 1 1 0 1 1 1 0 1 1 1 1 1 0 3 3 5 5 4 4 3 7 7 7 7 8 8 8 8 8 7 
7 7 7 7 7 7 8 7 7 7 3 5 5 5 5 3 5 6 6 6 6 6 2 2 2 2 2 6 6 2 3 2 6 2 6 6 6 6 6 2 2 2 3 2 3 2 2 6 6 2 3 2 2 2 2 2 3 6 6 6 3 1 1 1 1 1 1 1 1 1 1 1 1 1 1 1 0 1 1 1 1 0 0 3 3 5 5 3 3 3 7 7 7 7 7 7 7 7 8 8 
7 7 8 7 7 7 7 8 7 7 3 5 3 5 5 5 5 5 6 6 6 6 6 6 6 6 6 6 2 2 3 2 2 2 2 6 6 6 2 2 6 2 2 3 3 3 2 6 6 6 3 2 3 3 3 2 2 2 6 6 1 1 1 1 1 1 1 0 1 1 1 0 1 1 1 1 0 0 0 1 1 0 0 4 3 5 5 5 3 3 8 8 7 7 7 7 7 7 8 7 
7 7 7 8 7 7 7 7 7 7 7 3 3 4 5 5 5 6 6 6 6 2 6 6 2 3 3 2 2 2 3 2 2 2 2 2 2 2 2 2 2 2 3 2 2 2 6 6 2 2 2 2 2 3 2 3 6 6 6 6 1 0 1 1 1 1 1 1 1 1 1 0 1 1 1 1 1 1 0 1 1 0 4 3 3 5 5 3 3 3 7 7 7 7 8 8 7 7 7 7 
7 7 7 7 7 7 7 7 7 7 3 3 3 4 5 5 6 6 6 6 2 2 2 3 3 3 2 2 6 2 2 2 2 6 6 2 2 2 3 2 3 3 3 2 6 2 6 6 6 2 2 2 2 2 3 3 6 6 6 6 0 0 1 1 1 1 1 1 1 1 1 1 1 1 1 0 0 0 1 1 0 0 0 3 3 5 5 3 3 7 7 7 7 7 7 7 7 7 7 7 
7 7 7 8 8 7 7 7 7 7 3 5 5 4 5 5 6 6 6 6 2 3 3 3 3 2 6 6 6 2 3 3 2 2 2 2 2 2 3 3 2 2 2 2 2 2 6 6 6 6 2 6 6 6 6 6 6 6 1 1 1 1 1 1 1 1 1 1 1 1 1 1 0 1 1 1 1 0 0 1 1 4 3 3 5 5 3 3 7 7 7 7 8 7 7 7 7 7 7 7 
7 7 7 7 8 7 7 8 7 7 3 5 5 4 5 3 6 6 6 6 2 2 2 3 2 2 6 6 6 2 2 6 3 2 2 2 2 2 2 2 2 2 2 3 2 2 2 3 3 3 2 2 6 6 6 6 1 1 1 1 1 1 1 1 1 1 1 1 1 0 1 1 1 1 1 1 1 0 1 0 0 0 5 5 5 4 3 3 7 7 7 7 8 7 7 7 7 8 7 7 
7 7 7 7 8 8 8 7 7 7 3 3 5 5 5 4 4 6 6 6 6 2 2 2 2 6 6 6 2 2 2 2 6 3 3 3 2 3 2 2 2 2 2 2 2 3 3 2 2 2 6 6 6 6 6 1 6 1 0 1 1 0 0 1 1 1 0 0 1 0 1 1 0 1 1 1 0 0 1 0 3 3 5 5 5 5 3 7 7 7 7 7 8 7 7 7 7 8 8 7 
7 7 7 7 7 7 8 7 7 7 3 3 3 5 3 5 5 6 6 6 6 6 6 6 6 6 6 6 2 2 6 2 2 2 2 2 2 2 2 2 6 2 2 2 2 2 2 2 2 6 6 6 6 1 1 0 1 1 0 1 1 1 1 1 1 1 1 1 1 1 1 1 1 1 1 1 1 1 1 0 3 3 5 5 5 5 3 7 7 7 7 7 8 7 7 7 7 8 7 7 
7 7 7 7 7 8 7 7 7 7 3 3 3 4 4 4 4 4 3 3 3 1 6 6 6 6 6 6 2 3 2 2 2 6 2 2 2 2 6 2 2 2 2 3 3 6 2 6 6 6 6 1 1 1 1 0 1 1 1 1 1 1 0 0 1 1 1 1 0 1 1 1 1 1 1 1 1 1 1 0 3 5 5 5 4 3 3 7 7 7 7 7 8 7 7 7 8 7 8 7 
7 7 7 7 7 7 7 7 7 7 7 3 3 3 4 5 5 5 5 3 3 1 1 0 0 1 6 6 2 2 2 6 2 6 2 6 2 2 2 2 2 2 2 6 6 2 6 6 6 6 0 1 1 1 1 1 1 1 1 1 1 1 1 1 1 1 1 1 1 1 1 1 0 1 1 1 0 0 0 5 5 4 5 4 4 5 3 7 7 7 7 7 8 7 7 7 8 7 8 7 
7 7 7 7 8 7 7 7 7 7 7 5 3 3 5 5 4 3 3 3 3 1 1 0 1 1 0 6 6 6 6 6 6 6 6 6 6 6 6 6 2 3 6 6 6 6 6 6 6 6 1 1 1 0 1 0 0 1 0 1 1 1 1 1 1 1 1 1 1 1 1 1 1 0 0 1 1 1 1 5 1 5 5 5 5 4 4 7 7 7 7 7 8 7 7 8 8 7 7 7 
7 7 7 7 7 8 7 7 7 7 3 3 5 5 5 5 4 4 3 4 3 1 1 1 1 1 0 6 6 1 1 6 6 6 6 6 6 6 6 6 2 2 6 6 6 6 6 6 6 1 1 0 0 0 1 1 1 1 1 1 1 1 1 0 1 1 1 0 1 1 1 1 1 1 1 1 1 1 1 1 3 3 3 4 5 4 4 7 7 7 7 8 7 7 7 7 8 7 7 7 
7 7 7 7 7 7 8 7 8 7 7 7 3 5 5 5 4 4 3 3 4 1 1 1 1 1 0 0 1 1 1 1 6 1 1 1 1 1 1 2 2 2 1 1 1 0 1 1 1 0 0 1 1 1 1 1 1 1 0 1 1 1 1 1 0 0 1 1 1 1 1 1 1 1 0 0 1 1 1 3 3 3 3 4 5 4 3 7 7 7 7 8 7 7 7 7 7 7 7 7 
7 8 7 7 7 7 7 7 7 7 7 7 3 3 5 5 5 4 3 3 3 1 1 1 1 0 0 0 1 1 1 1 1 1 1 1 1 2 2 2 2 2 1 1 1 1 0 1 1 1 1 1 1 1 1 0 1 0 0 1 1 1 1 1 1 0 1 1 1 1 1 1 0 1 1 0 0 1 1 1 3 3 4 3 5 5 4 7 7 7 7 7 7 7 7 7 8 7 7 7 
7 7 7 7 7 7 7 7 7 7 7 3 3 3 5 5 5 4 5 3 3 1 1 1 0 0 0 0 1 1 1 0 1 1 1 2 2 2 2 2 2 2 1 1 1 1 0 1 1 1 1 1 0 0 0 0 0 0 0 0 0 0 0 1 1 1 0 1 1 1 1 1 0 1 1 0 0 1 1 3 3 4 4 3 4 5 4 7 7 7 7 7 7 7 7 7 7 7 7 7 
7 7 7 7 7 8 8 7 7 7 7 3 3 3 5 5 5 5 3 3 3 3 1 1 0 1 0 1 1 0 0 0 1 1 1 1 1 2 2 2 0 2 1 1 1 1 1 0 0 1 0 0 0 1 1 0 0 1 1 1 1 0 0 0 0 0 0 1 1 1 1 1 1 1 0 0 1 1 1 3 4 5 5 4 3 5 3 7 7 7 7 7 7 7 7 8 7 7 7 7 
7 7 7 7 7 8 8 7 7 7 8 7 7 3 3 5 5 3 5 3 3 4 1 1 1 1 1 1 1 1 1 0 1 1 1 2 2 2 2 2 2 2 1 1 1 1 1 1 0 0 0 0 0 1 1 0 1 1 1 1 1 1 0 1 1 1 0 1 1 1 1 1 0 0 1 1 1 1 3 3 4 5 5 4 3 5 3 7 7 7 7 7 7 7 7 8 7 7 7 7 
7 7 7 7 7 8 7 7 7 7 7 7 7 3 3 3 5 3 3 3 3 4 1 1 1 1 1 1 1 1 1 1 1 2 2 2 2 2 2 2 2 0 1 1 1 1 1 1 1 1 1 0 0 0 1 1 1 1 1 0 1 1 0 1 1 1 0 0 0 1 1 1 0 0 1 1 1 3 3 4 5 4 5 5 3 3 7 7 7 7 7 7 7 7 7 7 7 7 7 7 
7 7 7 7 7 7 7 7 8 8 7 7 7 7 3 3 5 5 3 3 3 3 1 1 1 0 1 1 1 1 1 1 2 2 2 2 2 2 1 1 0 1 1 1 1 1 1 1 1 1 1 1 1 1 1 1 1 1 1 1 1 0 0 1 1 1 0 1 1 1 1 1 0 1 0 1 1 3 3 4 3 5 5 4 4 3 7 7 7 7 7 7 7 7 8 7 7 7 7 7 
7 7 7 7 7 7 7 7 7 7 8 7 7 7 3 3 5 5 5 3 3 1 1 1 0 0 1 1 1 1 1 2 2 2 2 2 2 1 2 1 1 0 1 1 1 1 1 0 1 1 1 1 1 1 1 1 1 7 1 1 1 0 1 0 0 1 1 0 0 0 1 1 0 1 1 0 1 3 3 3 5 4 5 4 4 3 7 7 7 7 7 7 7 7 8 7 7 7 7 7 
7 7 7 7 7 7 8 8 7 7 8 7 8 7 7 3 3 3 5 3 3 1 1 0 0 1 1 1 1 1 2 2 2 2 2 2 2 2 2 1 1 1 1 7 7 1 0 0 0 0 0 1 1 1 7 1 7 7 1 1 1 0 0 1 1 1 0 1 0 0 1 1 0 1 1 0 1 1 3 3 5 5 5 5 4 5 5 7 7 8 7 7 7 7 8 7 7 7 7 7 
7 7 7 7 7 8 8 7 7 7 8 7 7 3 3 3 3 3 5 3 3 1 1 0 0 1 1 1 1 2 2 2 2 2 2 2 2 1 0 1 1 1 7 7 0 0 0 0 0 0 1 1 7 7 7 7 7 8 7 1 1 1 1 1 1 1 1 1 1 1 1 1 1 1 0 1 1 0 3 3 5 4 4 5 4 5 5 7 7 8 7 7 7 7 8 7 7 7 7 7 
7 7 7 7 7 8 7 7 7 7 8 7 7 3 3 3 3 3 3 3 3 1 1 0 0 1 1 2 2 2 2 2 2 2 1 1 1 1 0 1 1 1 7 8 0 0 0 0 0 7 7 7 7 8 8 8 7 8 7 0 1 1 1 1 0 1 0 1 1 1 1 1 1 1 1 1 1 1 0 3 5 3 4 5 5 5 3 3 3 7 7 7 7 7 7 7 7 7 7 7 
8 7 8 7 7 8 7 7 7 7 7 8 7 7 3 3 3 3 3 3 3 1 1 1 1 0 2 2 2 2 2 2 2 1 1 1 1 0 0 1 1 7 7 7 7 7 7 7 7 7 7 7 7 7 7 7 7 7 7 0 1 1 1 1 1 1 1 1 1 1 1 1 1 1 0 1 1 1 0 3 5 3 5 5 5 5 3 3 7 7 7 7 7 7 7 7 7 7 7 7 
7 7 8 8 8 8 8 8 7 7 7 7 8 8 7 3 3 3 3 3 3 1 1 0 1 2 2 2 2 2 2 2 2 0 1 1 0 1 1 1 1 1 7 7 8 7 7 7 7 7 8 7 7 7 7 8 7 7 7 7 0 1 1 1 0 1 1 0 0 1 2 2 2 1 1 1 1 0 3 3 5 3 3 4 5 3 3 3 7 7 7 7 7 7 7 7 7 7 7 7 
7 7 7 7 7 7 7 8 8 7 7 7 7 8 7 3 3 3 3 3 3 1 1 0 2 2 2 2 2 2 2 2 2 0 1 1 1 1 1 1 7 7 8 8 7 7 8 7 7 7 7 8 8 7 7 8 8 8 7 7 8 1 1 1 1 1 1 1 0 2 2 2 2 0 1 1 1 0 1 3 5 5 4 5 3 5 7 7 7 7 7 7 7 7 7 7 7 7 7 7 
7 7 7 7 7 7 7 7 7 8 8 7 7 7 3 3 3 5 3 5 3 1 1 0 2 2 2 2 2 2 2 1 1 0 1 1 1 1 1 8 8 7 7 7 7 7 7 7 8 7 7 8 8 7 7 7 7 8 8 7 8 0 1 1 1 1 1 1 0 2 2 2 2 2 0 1 1 1 1 4 5 5 4 5 5 3 7 7 7 7 7 7 7 8 7 7 7 7 7 7 
8 8 8 8 8 7 7 7 7 7 7 7 3 3 3 3 3 3 5 5 0 1 1 1 2 2 2 2 2 2 1 1 1 0 0 1 1 1 7 7 7 7 6 6 6 6 6 6 7 7 7 6 6 7 7 7 7 7 7 6 6 0 0 0 0 1 1 1 0 2 2 2 2 2 2 2 1 0 1 4 4 5 5 5 3 3 5 7 7 8 7 7 8 7 7 7 7 7 7 7 
7 8 7 7 7 8 8 7 7 8 8 7 3 3 3 3 5 3 5 3 0 1 1 0 2 2 2 2 2 2 1 1 1 1 0 1 1 2 7 7 7 6 6 2 2 2 2 6 6 6 6 6 6 6 6 6 6 6 6 6 2 2 2 2 2 0 0 0 2 2 2 2 2 2 0 1 1 1 3 3 4 5 5 5 3 5 7 7 8 7 7 7 8 7 7 7 7 7 7 7 
7 8 8 7 7 7 7 7 8 8 8 7 7 7 3 3 5 5 5 3 0 0 1 0 0 2 2 2 2 2 1 1 1 1 0 1 1 2 7 8 6 6 2 2 2 2 2 2 2 2 2 2 2 2 2 2 2 2 2 2 2 2 2 2 2 2 2 2 2 2 2 2 2 2 1 1 1 1 3 3 4 5 5 5 3 7 7 7 8 7 7 7 8 7 7 7 7 7 8 7 
7 7 7 8 8 7 7 7 7 7 8 7 7 7 3 3 5 3 5 3 3 0 0 1 0 2 2 2 2 0 0 1 2 2 2 2 2 2 8 6 6 2 2 2 2 2 2 2 2 2 2 2 2 2 2 2 2 2 2 2 2 2 2 2 2 2 2 2 2 2 2 2 2 2 0 1 1 1 3 3 5 5 5 5 3 7 7 8 7 7 7 8 8 7 7 7 7 7 8 7 
7 7 7 7 8 8 7 7 7 8 7 8 7 7 3 3 3 3 5 3 3 0 0 1 2 2 2 2 2 0 2 2 2 2 2 2 2 2 2 2 2 2 2 2 2 2 2 6 6 6 2 2 2 2 2 6 6 6 6 6 2 2 2 2 2 2 2 2 2 2 2 2 2 1 1 1 0 3 3 3 5 5 5 5 3 7 7 8 7 7 7 8 8 7 7 7 7 8 7 7 
7 7 7 7 7 7 7 7 7 7 8 7 7 7 3 3 5 3 5 3 3 1 0 1 2 2 2 2 2 2 2 2 2 2 2 2 2 2 2 2 2 2 6 6 6 6 6 7 6 6 6 6 6 6 6 6 7 7 7 6 1 2 2 2 1 1 1 1 2 2 2 1 2 2 1 1 1 3 5 5 5 5 3 3 3 7 8 8 7 7 7 7 7 7 7 7 7 8 7 7 
7 7 7 7 7 7 7 7 7 7 7 7 7 5 3 5 3 3 5 3 3 1 0 1 1 2 2 2 2 2 2 2 2 2 2 2 2 2 2 2 2 2 6 7 7 7 7 7 7 7 7 7 7 7 7 7 7 8 8 7 1 1 1 1 1 1 0 1 1 1 1 0 0 0 1 1 1 3 5 4 5 5 5 3 4 7 8 7 7 7 7 7 7 7 7 7 7 8 7 7 
7 7 7 7 7 7 7 8 8 8 7 7 5 5 3 3 3 5 5 3 3 1 1 2 2 2 2 2 2 2 2 2 2 2 2 2 2 2 2 2 1 6 6 7 8 8 8 7 7 8 7 8 7 7 8 7 7 8 7 7 1 1 1 1 1 1 1 0 1 1 1 0 1 0 1 1 3 3 5 5 5 5 5 3 3 7 7 8 7 7 7 7 7 7 7 7 7 8 7 7 
7 7 7 7 7 7 8 7 7 7 7 7 5 5 3 5 3 5 3 3 2 2 2 2 2 2 2 2 2 2 2 2 2 2 2 2 2 2 1 1 1 1 7 7 7 7 7 7 7 7 7 7 7 7 7 7 7 7 7 1 1 1 0 0 0 1 0 0 0 0 0 0 1 0 1 1 3 4 3 5 5 5 5 3 3 7 7 8 7 7 8 8 7 7 7 7 7 8 7 7 
7 7 7 8 7 8 7 8 7 7 7 5 3 5 5 5 5 5 3 3 1 2 2 2 2 2 2 2 2 2 2 2 2 2 2 0 1 1 1 0 1 1 1 1 1 1 7 8 7 7 7 7 7 8 8 7 8 7 1 1 1 0 1 1 0 1 0 0 0 0 0 0 0 1 0 0 3 3 3 5 5 5 5 3 3 7 7 8 7 7 8 8 7 7 7 7 7 8 7 7 
8 7 7 8 7 7 7 8 7 7 3 5 5 3 3 5 5 3 3 2 2 2 2 2 2 2 2 2 2 2 2 2 2 2 2 1 1 1 1 0 1 1 1 1 1 1 1 7 7 7 8 7 7 7 7 7 0 0 1 1 1 0 0 1 0 0 0 0 1 1 1 1 0 0 0 0 3 5 5 5 5 4 3 5 3 3 7 8 8 7 8 8 7 7 7 7 7 8 7 7 
8 7 7 8 7 7 7 7 7 3 3 5 5 5 3 3 3 3 2 2 2 2 2 2 2 2 2 2 2 2 2 2 2 2 2 1 1 1 1 1 1 1 1 1 1 1 1 1 7 7 7 7 7 8 1 1 1 1 1 1 1 0 1 1 0 1 1 1 1 1 1 0 1 1 0 5 5 5 5 5 5 4 5 5 3 3 7 8 8 7 8 8 7 7 7 7 7 8 7 7 
7 7 7 8 7 7 7 7 7 3 3 3 5 5 3 3 3 2 2 2 2 2 2 2 2 2 2 2 2 2 2 2 2 2 2 0 1 1 0 1 1 1 1 1 1 1 1 1 1 1 1 1 1 1 1 1 1 0 1 1 1 1 1 1 0 0 1 1 0 0 1 0 1 1 0 0 5 3 5 5 5 5 5 5 3 3 7 7 7 7 8 8 7 7 7 7 7 8 7 7 
7 7 7 7 8 7 7 7 7 5 5 5 5 3 2 5 2 2 2 2 2 2 2 2 2 2 2 2 2 2 2 2 2 2 2 0 1 1 1 0 0 1 0 0 1 1 1 1 1 1 1 1 1 1 1 1 1 1 1 1 1 1 1 1 1 0 0 0 1 1 1 0 0 0 0 0 5 3 5 5 5 5 5 5 3 3 7 7 7 7 8 7 7 7 7 7 7 7 7 7 
7 7 7 7 8 7 7 7 7 3 5 5 5 2 2 2 2 2 2 2 2 2 2 2 2 2 2 2 2 2 2 2 2 2 2 2 1 1 0 0 1 1 1 1 0 0 0 0 0 0 1 1 1 1 1 1 1 1 1 1 1 0 1 1 1 1 0 0 1 1 1 0 0 0 3 3 5 5 5 5 5 5 5 5 4 3 3 7 7 7 8 7 7 7 7 7 7 7 7 7 
7 7 7 7 8 7 7 8 3 3 3 5 5 3 2 2 2 2 2 2 2 2 2 2 2 2 2 2 2 2 1 2 2 2 2 2 1 1 1 1 1 1 1 1 0 0 0 0 1 0 1 1 1 1 0 0 1 1 0 1 1 0 1 1 0 1 1 0 0 1 1 1 1 1 3 3 3 5 5 5 5 5 5 4 4 3 7 7 7 7 8 7 7 7 7 7 7 7 7 7 
7 7 7 7 8 8 7 8 8 3 3 5 3 3 2 3 2 2 2 2 2 2 2 2 2 2 2 0 1 1 0 2 2 2 2 2 1 1 0 1 1 1 1 0 0 0 0 1 1 1 1 1 1 1 1 1 1 0 0 1 0 0 0 0 0 1 0 0 1 1 1 1 1 1 3 3 0 0 5 3 3 5 5 5 4 4 7 7 7 7 8 7 7 7 7 7 8 8 8 7 
7 7 7 7 8 8 7 7 7 7 3 5 5 3 3 2 2 2 2 2 2 2 2 2 2 2 2 0 1 1 1 2 2 2 2 2 2 1 0 1 1 1 1 1 1 1 1 1 1 1 1 1 1 1 1 1 0 0 0 0 1 1 1 1 1 1 0 1 1 0 1 0 1 1 1 0 3 3 5 3 3 5 5 3 3 4 3 7 7 7 7 7 8 7 7 7 7 7 8 7 
7 7 7 7 8 7 8 8 8 7 3 5 5 3 3 3 5 2 2 2 2 5 3 1 1 1 1 1 1 1 1 2 2 2 2 2 2 1 1 1 1 1 1 1 1 1 1 0 1 1 1 0 0 1 0 0 0 0 1 1 1 1 0 1 1 1 1 1 1 1 1 0 0 0 1 0 1 5 5 3 5 4 5 5 5 4 4 3 3 7 8 7 8 7 7 7 7 7 7 7 
7 7 7 7 8 8 7 7 7 7 7 5 5 5 3 5 5 5 5 3 3 5 3 1 1 1 1 0 1 1 1 2 2 2 2 2 2 1 0 1 1 1 0 0 1 1 0 0 0 0 0 1 1 0 1 0 0 0 0 0 1 1 0 1 1 1 1 1 1 1 0 0 0 0 1 0 1 1 1 3 5 5 5 5 5 3 4 3 7 7 8 7 7 8 7 7 7 7 7 7 
7 7 7 7 8 7 7 7 7 7 7 5 5 3 5 5 3 5 5 5 5 3 3 1 1 1 0 0 0 1 1 1 2 2 2 2 2 2 1 1 1 1 1 1 1 1 1 1 1 1 1 1 0 0 0 1 1 1 1 1 1 1 1 0 1 1 0 0 1 0 0 0 1 1 1 0 0 1 1 3 4 5 5 5 5 5 4 3 4 7 7 7 7 8 7 8 8 7 7 7 
7 8 7 8 8 7 7 7 7 7 7 7 3 5 5 5 3 5 5 3 3 3 5 0 0 0 0 0 0 0 0 1 2 2 2 2 2 2 1 0 1 1 1 1 1 1 1 0 0 1 0 1 1 1 1 1 1 1 1 1 0 1 1 0 0 0 1 1 1 1 1 1 0 0 0 0 1 1 0 0 3 5 5 5 4 4 5 4 4 3 7 7 7 7 7 8 7 7 7 7 
7 8 7 7 7 7 7 7 8 8 8 7 3 5 5 3 3 5 5 3 3 3 3 0 1 0 0 0 0 0 0 1 1 2 2 2 2 2 2 2 2 2 1 1 1 1 0 1 1 0 0 1 1 1 1 1 1 1 1 1 0 1 0 0 0 0 1 1 1 0 0 0 1 1 1 0 1 1 1 1 3 5 4 5 4 4 5 4 3 3 7 7 7 8 7 8 7 7 7 7 
7 8 7 7 7 8 7 7 7 7 8 3 3 3 5 3 3 5 5 3 3 3 1 1 1 0 0 0 0 0 0 1 1 2 2 2 2 2 2 2 2 2 2 2 2 2 1 0 1 0 1 1 1 1 1 1 1 1 1 0 0 0 0 0 0 0 1 1 1 1 1 1 0 0 1 1 1 1 1 1 4 3 5 4 5 4 4 5 3 3 7 7 7 8 7 8 7 7 7 7 
7 8 8 7 7 7 7 7 7 7 7 3 3 3 3 5 5 5 3 3 3 3 1 1 0 0 0 0 0 1 0 0 0 0 1 2 2 2 2 2 2 2 2 2 2 2 2 2 1 1 1 1 1 1 1 1 1 1 1 1 1 1 0 1 1 0 1 1 1 1 1 1 0 0 1 1 1 1 1 1 1 3 5 4 5 4 5 3 7 7 7 7 7 8 7 8 7 7 7 7 
7 7 7 7 7 7 7 7 7 7 3 3 3 3 3 5 5 5 5 3 3 3 1 1 1 1 1 1 0 1 1 1 0 0 1 0 2 2 2 2 2 2 2 2 2 2 2 2 2 2 1 2 2 2 2 2 2 1 1 1 1 1 1 1 1 0 1 1 0 1 1 0 0 0 0 0 0 0 1 1 3 3 5 3 5 4 5 5 3 7 7 7 7 8 7 7 7 7 7 7 
7 7 7 7 7 7 8 8 7 7 3 3 3 3 5 5 5 3 5 3 3 3 1 1 1 1 1 1 1 1 0 1 0 1 1 1 1 1 2 2 2 2 2 2 2 2 2 2 2 2 2 2 2 2 2 2 2 2 2 2 1 1 1 1 1 0 1 1 1 1 1 1 0 1 1 1 1 1 1 3 3 4 5 5 5 5 4 4 3 3 3 7 7 8 7 8 7 7 7 8 
7 7 7 8 8 8 7 8 7 7 7 7 3 3 3 5 3 5 5 3 3 3 1 1 1 0 1 1 1 1 0 0 0 0 1 0 0 0 0 0 1 2 2 2 2 2 2 2 2 2 2 2 2 2 2 2 2 2 2 2 2 2 2 2 0 0 1 1 1 0 0 0 0 0 1 1 1 1 1 1 3 3 5 5 5 3 3 4 5 5 7 7 7 8 7 7 7 7 7 8 
7 7 8 7 7 7 7 7 7 7 3 3 3 5 3 5 5 3 3 3 3 3 1 1 1 0 0 1 1 1 1 1 0 0 1 1 1 1 1 1 1 2 2 2 2 2 2 2 2 2 2 2 2 2 2 2 2 2 2 2 2 2 2 2 2 2 1 1 1 1 1 1 1 1 1 1 1 1 1 1 3 3 5 5 5 5 5 4 5 5 7 7 7 7 7 8 7 7 8 8 
8 7 7 7 7 7 8 8 7 7 3 3 3 5 5 5 3 3 3 3 3 3 1 1 1 1 1 1 0 0 0 0 0 0 1 1 1 1 0 0 0 1 0 2 2 1 1 2 2 2 2 2 2 2 2 2 2 2 2 2 2 2 2 2 2 2 2 2 1 0 1 1 1 1 1 1 1 1 1 1 1 0 3 5 5 5 5 5 5 5 7 7 7 7 7 7 7 7 8 8 
8 7 7 7 7 8 8 8 7 7 7 3 3 5 5 5 5 5 3 3 3 1 1 1 1 1 0 1 1 1 1 1 1 1 1 1 1 0 0 0 0 0 1 0 0 0 0 0 0 2 2 2 2 2 2 2 2 2 2 2 2 2 2 2 2 2 2 2 2 0 0 1 1 1 0 1 1 0 1 1 3 3 4 5 5 4 5 5 5 3 7 7 7 7 7 7 7 7 8 8 
8 7 7 7 8 8 7 8 7 7 7 3 3 5 3 5 5 5 3 3 3 1 1 1 1 0 0 1 1 0 1 1 1 1 1 1 0 1 0 0 0 0 1 1 1 1 1 0 0 1 2 2 0 2 2 2 2 2 2 2 2 2 2 2 2 2 2 2 2 2 2 1 1 1 1 0 3 4 3 3 5 4 3 5 5 5 5 4 4 3 5 7 7 7 7 7 7 7 8 7 
7 7 7 7 8 7 7 8 7 7 7 7 3 5 4 5 5 5 5 1 1 1 0 0 0 0 1 0 0 0 0 1 1 0 1 1 1 1 1 1 1 0 1 1 1 1 1 1 1 1 0 0 0 1 0 0 2 2 2 2 2 2 2 2 2 2 2 2 2 2 2 2 1 1 1 3 3 4 4 4 5 4 5 5 5 5 5 5 5 3 5 7 7 7 8 7 7 8 8 7 
7 7 8 8 8 7 7 8 7 7 7 3 3 5 3 3 5 5 3 0 0 0 0 0 1 0 0 1 0 1 0 0 0 1 0 1 0 1 1 1 1 0 1 1 1 1 1 0 0 1 1 1 1 1 0 0 0 0 2 0 2 2 2 2 2 2 2 2 2 2 2 2 2 2 2 2 3 4 5 5 5 5 5 5 5 4 5 3 3 7 7 7 7 7 8 7 7 8 7 8 
7 7 7 7 8 7 7 7 7 7 7 7 3 5 5 5 5 5 5 1 1 1 1 0 0 1 1 1 0 1 1 0 1 1 1 0 0 0 0 1 1 1 1 1 1 0 0 1 1 1 1 1 0 0 0 0 0 1 0 0 1 1 0 2 2 2 2 2 2 2 2 2 2 2 2 2 2 2 2 2 2 4 5 4 5 5 5 3 3 7 7 7 7 7 8 7 8 7 7 7 
7 7 7 7 8 8 7 7 7 7 7 7 3 3 3 5 5 3 5 1 1 1 1 1 0 1 1 1 1 1 1 1 1 1 1 1 1 0 1 0 1 0 1 1 0 0 1 0 0 0 0 1 0 1 0 1 1 1 0 0 0 0 0 0 1 0 2 2 2 2 2 2 2 2 2 2 2 2 2 2 2 4 3 4 4 5 5 3 3 7 7 7 7 7 7 7 8 7 7 7 
7 7 7 7 7 8 8 8 7 7 7 7 3 3 3 5 5 5 3 1 1 1 1 1 1 1 1 1 1 1 1 1 0 1 1 0 0 1 0 0 0 1 0 0 0 0 1 0 1 1 1 1 1 1 1 1 0 0 0 0 1 1 1 1 1 1 2 2 2 2 2 2 2 2 2 2 2 2 2 2 2 2 5 4 3 5 3 7 3 3 7 7 7 7 8 7 7 8 7 7 
7 7 7 7 7 7 7 8 8 7 7 7 3 5 3 4 3 3 3 3 1 3 3 1 1 0 1 0 1 1 1 0 0 0 1 1 1 1 0 0 0 0 0 1 0 0 0 1 1 5 5 3 3 3 3 5 5 5 5 1 1 0 2 2 2 2 5 3 2 2 2 2 2 2 2 2 2 2 2 2 2 2 2 4 4 4 5 7 7 7 7 7 7 7 8 7 7 8 7 7 
7 7 7 7 7 7 7 7 7 7 7 7 3 3 3 3 5 4 3 3 3 3 3 1 1 0 0 1 1 1 1 1 1 0 0 1 1 1 1 1 1 0 0 1 1 1 1 1 5 5 5 5 3 3 5 3 3 3 5 5 3 3 5 3 3 5 5 3 3 2 2 2 2 2 2 2 2 2 2 2 2 2 2 4 3 4 5 4 7 7 7 7 8 7 8 7 7 8 7 7 
7 7 7 7 8 7 7 7 7 7 7 7 3 3 3 4 5 4 5 3 3 3 3 3 1 1 1 1 1 5 5 1 5 5 5 5 3 1 0 0 0 0 1 1 1 1 5 3 5 5 5 5 5 5 5 5 5 3 5 5 5 5 5 5 5 5 5 5 5 5 5 5 5 2 2 2 2 2 2 2 2 2 2 3 3 5 5 3 7 7 7 8 7 7 8 7 7 8 7 7 
7 7 7 7 8 8 8 8 7 7 7 7 3 3 3 3 3 4 5 5 3 3 3 3 3 3 3 5 5 5 3 3 3 3 3 3 3 3 3 3 3 5 3 3 5 3 5 5 5 5 5 3 5 5 5 3 5 4 5 5 5 5 5 5 5 3 5 5 5 5 5 5 5 5 2 2 2 2 2 2 2 2 2 5 4 5 4 3 7 7 7 7 8 8 8 7 7 8 8 7 
7 7 7 8 8 8 8 8 7 7 7 7 7 7 3 5 5 3 3 3 4 5 3 4 4 3 5 3 3 3 4 5 5 5 5 5 5 5 5 5 5 5 5 5 3 4 5 5 5 5 4 3 5 5 3 5 5 3 5 5 3 5 5 5 5 5 5 5 5 5 5 5 5 5 5 2 2 2 2 2 2 2 3 3 5 5 5 3 7 7 7 8 8 8 7 7 8 7 8 7 
7 7 7 7 8 7 7 8 8 7 7 7 7 7 3 3 5 5 3 3 5 5 4 3 5 5 4 5 4 4 5 5 5 4 4 3 3 5 5 5 5 5 5 5 5 4 5 4 8 8 4 3 3 5 5 5 3 5 5 4 3 3 5 3 3 3 5 5 4 3 3 5 5 3 5 2 3 2 2 2 2 3 3 3 3 5 5 3 7 7 8 8 8 7 7 7 8 7 8 7 
7 7 7 7 8 7 7 7 8 8 7 7 7 7 7 7 4 4 5 3 5 5 3 3 3 3 3 5 5 5 5 5 5 3 3 3 3 3 3 5 5 3 5 5 4 4 5 3 3 8 7 7 7 7 4 4 4 5 5 7 3 3 3 7 7 3 3 5 3 7 3 5 5 4 5 4 5 5 7 3 3 3 7 7 3 3 3 3 7 8 8 8 7 7 7 8 8 7 8 7 
7 7 7 7 8 7 7 7 7 7 8 7 7 7 7 7 7 7 7 3 3 3 3 5 3 3 3 3 3 3 3 3 3 3 3 3 7 7 4 4 5 4 4 4 4 4 7 7 7 7 7 7 7 7 7 7 7 7 7 7 7 7 7 7 7 7 7 7 7 7 7 3 3 3 4 3 7 7 7 7 7 7 7 7 7 7 7 7 7 7 8 7 7 7 7 8 8 7 8 7 
7 7 7 7 8 8 8 7 7 7 8 8 7 7 7 7 7 7 7 7 7 3 3 5 3 3 3 3 3 3 7 7 7 7 7 7 7 7 7 7 7 3 3 4 4 4 3 7 7 7 7 7 7 7 7 7 7 7 7 7 7 7 7 7 7 7 7 7 7 7 7 7 3 3 3 7 7 7 7 7 7 7 7 7 7 7 7 7 7 7 8 7 7 7 7 8 7 7 8 7 
7 7 7 7 7 7 8 8 8 8 7 7 7 7 7 7 7 7 7 7 7 7 7 7 7 7 7 3 3 7 7 7 7 7 7 7 7 7 7 8 8 7 3 3 3 7 7 7 7 7 8 8 7 7 7 7 7 8 7 7 7 7 7 7 7 7 7 7 7 7 7 7 7 7 7 7 7 7 7 7 7 7 7 7 7 8 7 7 8 7 7 7 7 7 7 7 7 7 8 7 
7 7 7 7 7 7 7 7 7 7 7 7 8 7 7 7 8 8 7 7 7 7 7 7 7 7 7 7 7 7 7 7 7 7 7 8 7 7 7 7 7 7 7 7 7 7 7 7 7 8 7 7 7 7 8 7 7 8 7 7 8 7 7 7 7 8 7 7 7 7 7 7 7 7 7 7 7 7 8 7 7 7 7 7 7 7 8 8 7 7 7 7 7 7 7 7 8 8 7 7 
7 7 7 7 7 7 7 7 7 7 7 7 8 7 7 7 8 8 8 7 7 7 7 8 8 8 8 7 7 7 7 7 7 7 7 7 7 7 7 7 7 7 7 7 7 7 7 7 7 8 7 7 7 7 8 8 7 7 7 7 7 7 7 8 7 7 8 7 8 7 7 7 7 8 8 7 7 8 8 7 7 7 7 8 8 8 7 7 7 7 7 7 7 7 8 8 8 7 7 7 
7 7 7 7 7 7 7 7 7 7 7 7 7 8 7 7 7 8 7 8 7 7 8 8 7 8 7 7 7 7 7 7 7 7 8 7 7 7 7 8 7 7 7 7 7 7 7 8 8 7 8 7 7 7 7 7 7 7 7 7 7 7 7 7 7 7 7 7 7 8 8 8 8 7 8 8 7 7 7 7 7 8 8 7 7 7 7 7 7 7 7 7 8 8 7 7 7 7 7 7 
7 7 7 7 7 7 7 7 7 7 7 7 7 8 7 7 7 7 7 7 7 7 7 8 7 7 7 7 7 7 7 7 8 7 8 7 7 7 7 8 8 8 7 7 7 7 7 7 8 8 7 8 8 7 7 7 7 7 7 8 8 8 8 7 7 7 8 7 7 7 7 7 7 7 7 7 8 8 8 8 8 7 7 7 8 7 7 8 7 8 8 8 8 7 7 7 7 7 7 7 
